00000000222000000000
00000002000200000000
00000020000020022222
00000200000002200002
00002000001000000002
00020000001100000012
00200000002220000112
02000000000000002222
20000000000000100002
23000000000002220002
22000022000200000012
02000022100220002222
02000022222220022000
02220020000020220000
00020220000022200000
00022200000000000000
