022200000002222000222222200
200020000020000202000000020
200002000200000220000000002
210000222000020200000222002
211000000000220000002202002
222200000002200000000002302
000220000000000002200002202
002000010200000020020000002
002000012020000200020000002
020002220002000020020000012
020000002020000002200000112
200000000200000000000222222
200000000000010000000000002
200001000000222000000000012
200022200000000000000000112
200000000100000001000001112
222222222222222222222222222
