0000022200002222222220
0222200022220000000002
2000000000000000000002
2000000000000000000002
2000002000000000000002
2000002000000000000002
2000002111100000000002
2300022222220000000002
2202220000022020000012
0202000000002022000112
0202000000002022001112
0222000000002022222222
0000000000002220000000