0200000000000000000
0200022222222222220
2020200000000000002
2002000000000000002
2000000000000000012
2000000000000000112
2022200000000210220
2020200002002222200
2020211022002000000
2320222222022000000
2220220002220000000