20000000000000000002
20000000000000000002
20000000000000000002
20000000000000000002
20002000000020000002
23002000201020100002
22222222222222222222