022200000000000002222
020022222222222220002
220000000000000000002
230000000000000000002
220000000000000000002
020000000000000000112
021100000000200100222
021110000000201110200
021111000000222220200
022222000022200022200
000002000120000000000
000002202220000000000
000000222000000000000
