000000000000000000200000
000000000000000002020000
000000020000000020002000
000000202000000200000200
000222000200002000000020
002000000020020000000002
020000000002200000000002
020000000000000000000012
020000000000000000000112
020000000000000000000222
220000200000000002000200
230000201000000002222200
222220201000100222000000
000020201020210200000000
000020222222222200000000
000022200000000000000000