000222222222222222222222000
022000000000002000000000200
222210000000112100011101220
200220020002222200122202202
200020022000000002220222002
200022002211110000000000002
230000000222222200000000002
220000000020002220000000022
020000010002020022000000002
020000020000200002200000002
022220022000000000000022222
000222220000000000000000002
000200000000002000000000000
000200000000022000022222222
000200000000220000000000020
000200000000001000000000120
000210000222222222220001120
000211002200000000022011120
000222222000000000002222220
