22222222222222222222222222222
20020002000000000000000000002
20000012110000000000002222202
21000222012200000100220030202
21100002220000001000000020202
22200112000002010000000000202
20002222000000200222000222002
21000000000000202000000200102
21100000002220202100002002222
22220100022200202210020102002
20000000000010222001200020002
20001000001102000222200000002
20000222222222000000002222202
20000000000000010001220000202
22220000000000010002000011202
20220002000020000000000222202
22022202000020001110100000002
20202022000020000000011100002
22222222222222222222222222222
