002000222220002200022200
020202000002020020200020
020022000000220002200002
020002000000020000200002
020000000000000000000012
020000000000000000000012
220000000000000000000112
230001000000000000000222
220002010000020000220200
020002010000220100222200
022002011100220111200000
002002222220222222200000
002202000022200000000000
000222000000000000000000
