0200002200000000220000
0200000000000000002000
2200000000000000000200
2300000000000000000020
2200000000000000000002
0200000000000200100002
0200000000000210110002
0222220002222222222222
0000020012000000000000
0000022222000000000000